11111111111111111111111111111111
1C000000011111111110000000000001
1000000000000000000011111110E001
1000000001000000001C0000001000C1
11110011111110011111111100111111
1C11001111111001111000C100000001
1000001C011110011110111111000001
11100011011110011110111100000001
1C010011011110011110111000000001
10000011011100001110110000000001
1000001EC11000000110100000000001
10010010010000000000000C00000001
10100000010000P00010000000000001
11111111111111111111111111111111
