1111111
100CP01
1C00001
1E00C01
1111111
