11111111111111111111111111111111111111111111111111111
1000000000001000101000101111010101010000P000000000001
10001111111111111110000000000111000000001001100110011
10000000C00000000C000000C0000000000000011100110010111
11111111111111111111111111100000000000111111111111111
10000C00000000111111111111000000000111111111111111111
1000000000000011111111111111111100000C0000000C0000001
10000000000111111111111111111111111111111111111100011
10000001111100000111111111111111111110000000000000001
11111111111111111111111111111111111111100011111111111
1111111111111111111111111111111111111111E111111111111
11111111111111111111111111111111111111111111111111111
