11111111111111111111111111111111111111111111111111
11000001000000010000000010101100001000000000100011
1CC00000001010100000001000010100100100000000000101
100C0101010000011001000000000110000000101010010001
1000CC00100100100100110011000001110100100010001011
10000001111000101110101000000001000100100000101011
10000C00011000000010001110000001101000011010011001
10000000010100000001000000100100000010000010010001
110001C0100000000000011000000000110010000010000111
1000011C0CC000001000000000000011010000110000000001
10101000100001000000010000000000010010010001100001
100000010000CC0001000111100010010010100000001C1001
11011001000110011000010001000001000000001000100101
1000000100000C010000C00010000010E01000000000001011
1000100011000100010100000CC00000000101000010011111
10001010000100000110001000CC0001111000000000100001
100000010010000000000001000000C0010001010001010101
10000010011000010010001110101100000000000100110001
100111100001000000000000000000C0000000010100010001
110000010000000001001001000010000101C0000010000011
10010100010010000010000001000000000000000000000011
1001110000100001110010011001000000000C0110C1001001
1101000100010000000000000100010001100111010C100001
1000101000100010100000000000000010000000100C100001
10010000001111000001010000000100000010000000C10001
10110000000000000000001010000000000000100000010111
10100000100000110100100000010001100011000110000001
10000000000010000011100000001110000000000001100001
10000000000000100110000110000100011000000101000001
10100001100000100100101100111111110000000000000001
10001000010100010110100000000011000000000001000001
10000001000001000001000000000000100010100001001001
10101000000000010101001001000001000110000011C10001
10011000000000000001110110000100000000101101001011
1011000000100100P000100000000000000000101100001001
10000001001010000010000011000110010100101000101001
100001001000001000000000010000100100010111001C1001
111000001100010000111001001010000000110000100C1001
10110001000100000010011100001100111000011000100011
1000100011100001010000000000000001010000100010C001
10000010010000010010000010000000000100010010001001
11000001000011000000010100010001011001010100000001
11100001010110000000010100000100000000110010010011
1100010011000100000000000000000000110000000000C111
10110010000100001000101000100001010000000010110101
1001011101001001000100010000000011001000011000C011
100000010000110000010001001000000100000100000000C1
11000010000111100100010011001010010000101010010011
10000001000000000000100000000000001000100010001011
11111111111111111111111111111111111111111111111111
