1111111111111111111111111111111111111
1000000000000000000000000000000000011
1000000000000000000000000000000000001
0111111111111111111111111111111111111
1111111111111111111111111111111111110
1111111111111111111111111111111111111
