1111111111
1001000101
1110101001
10CCC10P11
1CC00C1101
101101C001
10E000C001
1100101CC1
1011100001
1111111111