11111111111111111111111111111111
10100000010000110000000000000011
1CC000011100000101010000111E1001
11000C01C01100001001000100001101
100000010CC001010100000010100101
10101000000C0CC100P0001000100001
10100000001110C11000000100000101
100000011011100CC010001100000001
10001000010000000C00100000101001
110101010000010000C1000000100001
10000000100000000000C10010010001
100000000100010000010CC0C0100001
1000010001110110011000000001C001
1000000010010001010001001100C001
10001010001001000001001000000C01
11111111111111111111111111111111