111111111111111111111111111
1000CE000101000111101110011
10C00C111000CC1C001C0C101C1
100000001E010010CCCCC1C0111
1000100010C00C0010110C1C001
100C00CC0C000C0C00000CC0001
100C0101C110010CC0C000C1C01
101C01C100C0C0C0000001C0C01
10C011110CC0C111C0000C0C001
10011C01C0C1C00110000000C01
1011000CC001001010011000001
1100000000C00C11100C0C11001
1P000C10100C00000100001C101
10000101CCC0C010C10C0C110C1
10011CCC0C000011110C0CC0C01
10101CC11C100001101C0001C01
1100001100CC011C0C100000011
1010C011101C00CC11000010011
110010C0C10C01C111101CC0C01
1C000C010100110001000111001
100C000C0000CCC10101C011C01
110CCCCCC1100101C0C010C1001
1C0000C0010CC010C00000C0101
10C0C1CC01C1C010C001010CC11
1C0C0E0C101C0C10C0010100101
111111111111111111111111111
