1111111111111111111111111111111111
1CC0000010010101000001101000000001
11CC000000000011011000000100101011
1001CC100001C001000000000101010001
10000CCC10100001000100000110001101
1001001CC0001100110000010001101001
10111010C0000100011100100001001011
1000000CCC010011100010001000000001
111110000C000110000000E00110001001
100100C101CC0100100001111000001001
100001101001000C0C0001010000000101
1010001101000110000C00C00010100101
1000010000000100000101CC0111100101
10000100000000000001000C0100011011
1100000011001110001000100C0C100111
1000CC000001101000010010001CCP0011
10100100101101100001001000110CCC01
1000000110001010010000000100001111
1101000000000000000001001000010C01
1111111111111111111111111111111111