111111111111111111
1C0EC1001010110101
101000C110C110CC01
100CC0CC00011C0C01
101C111CC000100001
10C100C0100CC010C1
1C00110E0C00010101
100011000001CCC101
100010000CC0001C01
100C0011C000000C01
1C0001000011C000C1
100CC0011C00C00001
10C01C11010100PC01
1CC0010C01101CC111
1CC001CCC0C00010C1
100E0C0C0C101CC0E1
111111111111111111
