1111111111111111111111111111111111
100CCC1000101000000101000000100101
1C0C0000C0000000000000101010001001
10010C10001000C0000000000001000001
1000C0CCCC100101010110010000000101
1000000000C00E1C001110010011000001
1100000000C00010000011001100010011
11000C1010CCC010101100000100100011
100000101011C000110110000010001001
111000000001C0000C0100001000000001
1100000001110CCC00C000111000101001
1000001C000C1011C10000000101111001
1100000010000100000100000000001001
10001001000000001CC011000000000001
1111010100000P00000CCC100010010101
10100000C0000000C001010CCC1C010101
100010001000000010101010010C000001
1010100000000010100010100001C10001
10000100000000100000001100001C0CC1
1111111111111111111111111111111111