11111111111111111
1E111C10E110EC101
10E1E00000CC1ECE1
1C11C0CEE1E0E1PE1
100E000C1E0E1CC01
111EE0CE1EEEECC01
1EE1EE0ECC1EE1C11
10CCEC10E1E11EC01
1001CC0001CEE01E1
11CE0E001CE0E1101
10E10CECECCC1ECE1
1ECCCC101EC10ECE1
1C1E1C0C1EE1E10C1
1EE1E00CC10ECCEC1
1C1C10E1CCCEECCE1
11111111111111111
